disease_name|disease_definition|disease_symptoms
Asthma|A chronic respiratory condition characterized by airway inflammation and narrowing|Shortness of breath| wheezing| chest tightness| coughing
Diabetes Mellitus|A metabolic disorder characterized by high blood sugar levels over a prolonged period|Increased thirst| frequent urination| extreme hunger| unintended weight loss
Hypertension|A condition in which the force of the blood against the artery walls is too high|Headaches| shortness of breath| nosebleeds| chest pain
Influenza|A contagious respiratory illness caused by influenza viruses|Fever| chills| muscle aches| cough| congestion| runny nose| headaches| fatigue
Osteoarthritis|A degenerative joint disease causing the cartilage within a joint to break down|Joint pain| stiffness| swelling| decreased range of motion
Alzheimer's Disease|A progressive neurological disorder that causes brain cells to waste away and die|Memory loss| confusion| difficulty thinking and understanding| changes in personality
Rheumatoid Arthritis|An autoimmune disorder that primarily affects joints causing inflammation|Painful swelling| stiffness| and deformity of joints| fatigue| fever| loss of appetite
Epilepsy|A neurological disorder marked by sudden recurrent episodes of sensory disturbance| loss of consciousness| or convulsions|Seizures| temporary confusion| staring spells| uncontrollable jerking movements
Chronic Obstructive Pulmonary Disease (COPD)|A group of lung diseases that block airflow and make breathing difficult|Shortness of breath| wheezing| chronic cough| frequent respiratory infections
Psoriasis|A skin disease marked by red| itchy| scaly patches|Red patches of skin covered with thick| silvery scales| dry and cracked skin| itching| burning
Migraine|A neurological condition characterized by intense| debilitating headaches|Severe throbbing pain or a pulsing sensation| usually on one side of the head| nausea| vomiting| sensitivity to light and sound
Parkinson's Disease|A progressive nervous system disorder that affects movement|Tremors| stiffness| slowness of movement| balance problems
Celiac Disease|An immune reaction to eating gluten| a protein found in wheat| barley| and rye|Diarrhea| bloating| gas| fatigue| anemia| osteoporosis
Multiple Sclerosis|An autoimmune disease that affects the brain and spinal cord|Numbness or weakness in limbs| partial or complete loss of vision| double vision| tingling or pain in parts of the body
Lupus|An autoimmune disease where the body's immune system becomes hyperactive and attacks normal| healthy tissue|Fatigue| joint pain| rash| fever
Anemia|A condition in which you lack enough healthy red blood cells to carry adequate oxygen to your body's tissues|Fatigue| weakness| pale or yellowish skin| irregular heartbeats| shortness of breath| dizziness| chest pain
Hepatitis B|A serious liver infection caused by the hepatitis B virus (HBV)|Abdominal pain| dark urine| fever| joint pain| loss of appetite| nausea| vomiting| weakness| yellowing of your skin and the whites of your eyes (jaundice)
Chronic Fatigue Syndrome|A complicated disorder characterized by extreme fatigue that can't be explained by any underlying medical condition|Extreme fatigue| sleep that isn't refreshing| difficulty with memory| focus| and concentration| dizziness
Crohn's Disease|A type of inflammatory bowel disease (IBD) that can affect any part of the gastrointestinal tract|Abdominal pain| severe diarrhea| fatigue| weight loss| malnutrition
Ulcerative Colitis|A chronic| inflammatory bowel disease that causes inflammation in the digestive tract|Diarrhea| often with blood or pus| abdominal pain and cramping| rectal pain| rectal bleeding| urgency to defecate
Huntington's Disease|An inherited disease that causes the progressive breakdown (degeneration) of nerve cells in the brain|Involuntary jerking or writhing movements (chorea)| muscle problems| such as rigidity or muscle contracture (dystonia)| slow or abnormal eye movements| impaired gait| posture and balance| difficulty with speech or swallowing
Eczema|An inflammatory condition of the skin characterized by red| itchy| and inflamed patches of skin|Itching| red to brownish-gray patches| small| raised bumps| which may leak fluid and crust over when scratched
Gout|A form of arthritis characterized by severe pain| redness| and tenderness in joints|Sudden and intense pain in a joint| typically the big toe| swollen| red| hot| and stiff joints
Varicose Veins|Enlarged| twisted veins| often appearing in the legs|Aching pain and discomfort| burning| throbbing| muscle cramping and swelling in the lower legs
Sinusitis|Inflammation or swelling of the tissue lining the sinuses|Thick| yellow or greenish mucus from the nose| nasal congestion| pain| tenderness| swelling and pressure around your eyes| cheeks| nose or forehead| reduced sense of smell and taste
Bronchitis|Inflammation of the lining of your bronchial tubes| which carry air to and from your lungs|Cough| production of mucus (sputum)| fatigue| shortness of breath| slight fever and chills| chest discomfort
Cellulitis|A common| potentially serious bacterial skin infection|Red area of skin that tends to expand| swelling| tenderness| pain| warmth| fever
Tonsillitis|Inflammation of the tonsils| two oval-shaped pads of tissue at the back of the throat|Red| swollen tonsils| white or yellow coating on the tonsils| sore throat| difficult or painful swallowing| fever| enlarged| tender glands (lymph nodes) in the neck
Vertigo|A sensation of feeling off balance|Spinning| tilting| swaying| unbalanced| pulled to one direction| nausea| vomiting| abnormal or jerking eye movements (nystagmus)| headache| sweating
Bell's Palsy|A condition that causes a temporary weakness or paralysis of the muscles in the face|Rapid onset of mild weakness to total paralysis on one side of your face| facial droop and difficulty making facial expressions| pain around the jaw or in or behind your ear on the affected side| increased sensitivity to sound on the affected side
Herpes Zoster (Shingles)|A viral infection that causes a painful rash| often with blisters|Pain| burning| numbness or tingling| sensitivity to touch| red rash that begins a few days after the pain| fluid-filled blisters that break open and crust over
Hypothyroidism|A condition in which your thyroid gland doesn't produce enough of certain crucial hormones|Fatigue| weight gain| cold intolerance| dry skin| constipation| puffy face| muscle weakness
Hyperthyroidism|A condition in which your thyroid gland produces too much of the hormone thyroxine|Unintentional weight loss| rapid heartbeat (tachycardia)| irregular heartbeat (arrhythmia)| sweating| nervousness or irritability
Meningitis|Inflammation of the membranes (meninges) surrounding your brain and spinal cord|Sudden high fever| stiff neck| severe headache| nausea or vomiting| confusion or difficulty concentrating| seizures| sleepiness or difficulty waking| sensitivity to light
Chlamydia|A common sexually transmitted infection caused by bacteria|Painful urination| vaginal discharge in women| discharge from the penis in men| pain during sexual intercourse in women| testicular pain in men
Gonorrhea|A sexually transmitted infection caused by bacteria|Thick| cloudy or bloody discharge from the penis or vagina| pain or burning sensation when urinating| heavy menstrual bleeding or bleeding between periods| painful| swollen testicles| painful bowel movements| anal itching
Syphilis|A bacterial infection usually spread by sexual contact that starts as a painless sore|Painless sores on the genitals| rectum or mouth| rash| swollen lymph nodes| fever
AIDS (Acquired Immunodeficiency Syndrome)|A chronic| potentially life-threatening condition caused by the human immunodeficiency virus (HIV)|Rapid weight loss| recurring fever or profuse night sweats| extreme and unexplained tiredness| prolonged swelling of the lymph glands in the armpits| groin| or neck| diarrhea that lasts for more than a week| sores of the mouth| anus| or genitals| pneumonia
Tuberculosis (TB)|A potentially serious infectious disease that mainly affects the lungs|Coughing that lasts three or more weeks| coughing up blood| chest pain| or pain with breathing or coughing| unintentional weight loss| fatigue| fever| night sweats| chills| loss of appetite
Measles|A viral infection that's serious for small children but is easily preventable by a vaccine|Fever| dry cough| runny nose| sore throat| inflamed eyes (conjunctivitis)| tiny white spots with bluish-white centers on a red background found inside the mouth on the inner lining of the cheek| a skin rash made up of large| flat blotches that often flow into one another
Mumps|A viral infection that affects the salivary glands|Swollen| painful salivary glands on one or both sides of your face (parotitis)| fever| headache| muscle aches| weakness and fatigue| loss of appetite
Rubella|A contagious viral infection best known by its distinctive red rash|Mild fever| headache| stuffy or runny nose| inflamed| red eyes| enlarged| tender lymph nodes at the base of the skull| the back of the neck and behind the ears| a fine| pink rash that begins on the face and quickly spreads to the trunk and then the arms and legs| aching joints| especially in young women
Chickenpox|A highly contagious viral infection causing an itchy| blister-like rash on the skin|Fever| loss of appetite| headache| tiredness and a general feeling of being unwell (malaise)| itchy rash that turns into fluid-filled blisters that eventually turn into scabs
Whooping Cough (Pertussis)|A highly contagious respiratory tract infection|Runny nose| nasal congestion| red| watery eyes| fever| cough which may bring up thick mucus
Diphtheria|A serious bacterial infection usually affecting the mucous membranes of your nose and throat|Sore throat| hoarseness| swollen glands (enlarged lymph nodes) in your neck| difficulty breathing or rapid breathing| nasal discharge| fever and chills| malaise
Tetanus|A serious bacterial infection that causes painful muscle spasms and can lead to death|Spasms and stiffness in your jaw muscles| stiffness of your neck muscles| difficulty swallowing| stiffness of your abdominal muscles| painful body spasms lasting for several minutes| typically triggered by minor occurrences| such as a draft| loud noise| physical touch or light
Anthrax|A rare but serious illness caused by a spore-forming bacterium|Flu-like symptoms| such as sore throat| mild fever| fatigue and muscle aches| which may last a few hours or days| mild chest discomfort| shortness of breath| nausea| coughing up blood| painful swallowing| swelling of neck
Leprosy|A chronic infectious disease caused by Mycobacterium leprae|Discolored patches of skin| usually flat| that may be numb and look faded (lighter than the surrounding skin)| growths (nodules) on the skin| thick| stiff or dry skin| painless ulcers on the soles of feet| painless swelling or lumps on the face or earlobes| loss of eyebrows or eyelashes
Malaria|A disease caused by a plasmodium parasite| transmitted by the bite of infected mosquitoes|Chills| fever| sweating| headache| nausea| vomiting| abdominal pain| diarrhea| anemia| muscle pain| convulsions| coma| bloody stools
Zika Virus|A disease caused by a virus transmitted primarily by Aedes mosquitoes|Fever| rash| headache| joint pain| conjunctivitis (red eyes)| muscle pain
Dengue Fever|A mosquito-borne viral disease occurring in tropical and subtropical areas|High fever| headache| rash| muscle and joint pain| severe pain behind the eyes| mild bleeding (such a nose bleed| gum bleed| or easy bruising)
Chikungunya|A viral disease transmitted to humans by infected mosquitoes|Fever| joint pain| headache| muscle pain| joint swelling| rash
Yellow Fever|A viral infection spread by a particular species of mosquito|Fever| headache| jaundice| muscle pain| nausea| vomiting| fatigue
Ebola Virus Disease|A severe| often fatal illness in humans caused by the Ebola virus|Fever| severe headache| muscle pain| weakness| fatigue| diarrhea| vomiting| abdominal (stomach) pain| unexplained hemorrhage (bleeding or bruising)
Rabies|A deadly virus spread to people from the saliva of infected animals|Fever| headache| nausea| vomiting| agitation| anxiety| confusion| hyperactivity| difficulty swallowing| excessive salivation| hallucinations| insomnia| partial paralysis
Lassa Fever|An acute viral haemorrhagic illness caused by Lassa virus|Fever| general weakness and malaise| headache| sore throat| muscle pain| chest pain| nausea| vomiting| diarrhea| cough| abdominal pain
Nipah Virus Infection|A zoonotic virus (transmitted to humans from animals) with high fatality rates|Fever| headache| drowsiness| disorientation| mental confusion| coma| and potentially death
Marburg Virus Disease|A severe and often fatal hemorrhagic fever caused by Marburg virus|Severe headache| malaise| high fever| severe hemorrhagic manifestations
Hantavirus Pulmonary Syndrome|A severe| sometimes fatal| respiratory disease in humans caused by infection with hantaviruses|Fatigue| fever| muscle aches| especially in the large muscle groups—thighs| hips| back| and sometimes shoulders| headaches| dizziness| chills| and abdominal problems| such as nausea| vomiting| diarrhea| and abdominal pain
Avian Influenza (Bird Flu)|A viral infection spread from bird to bird|Flu-like symptoms| such as cough| fever| sore throat| muscle aches| headache| and shortness of breath
Swine Flu|A human respiratory infection caused by an influenza strain that started in pigs|Fever| cough| sore throat| runny or stuffy nose| body aches| headache| chills| fatigue
MERS (Middle East Respiratory Syndrome)|A viral respiratory illness caused by a coronavirus|Fever| cough| shortness of breath
SARS (Severe Acute Respiratory Syndrome)|A contagious and sometimes fatal respiratory illness caused by a coronavirus|Fever| dry cough| headache| muscle aches| difficulty breathing
COVID-19|An infectious disease caused by the most recently discovered coronavirus|Fever| dry cough| tiredness| aches and pains| nasal congestion| headache| conjunctivitis| sore throat| diarrhea| loss of taste or smell| a rash on skin| or discoloration of fingers or toes
Lyme Disease|A tick-borne illness caused by the bacterium Borrelia burgdorferi|Fever| headache| fatigue| a characteristic skin rash called erythema migrans
Rocky Mountain Spotted Fever|A bacterial infection transmitted by a tick|High fever| chills| severe headache| muscle aches| nausea and vomiting| confusion or other neurological changes| a red| non-itchy rash that usually starts at the wrists| forearms and ankles
Toxoplasmosis|An infection caused by a parasite| usually contracted from contaminated food or cat feces|Fever| swollen lymph nodes| headache| muscle aches and pains
Giardiasis|An intestinal infection caused by a giardia parasite|Diarrhea| gas| greasy stools that tend to float| stomach cramps| upset stomach or nausea| dehydration
Amebiasis|A parasitic infection of the intestines caused by Entamoeba histolytica|Loose stool| stomach pain| cramping| bloody stools| fever
Schistosomiasis|A disease caused by parasitic flatworms called schistosomes|Rash or itchy skin| fever| chills| cough| muscle aches
Onchocerciasis (River Blindness)|A disease caused by infection with the parasitic worm Onchocerca volvulus|Itching| bumps under the skin| blindness
Fascioliasis|A parasitic worm infection caused by Fasciola hepatica|Abdominal pain| fever| vomiting| diarrhea| hives| weight loss| liver damage
Tetanus|A bacterial infection characterized by muscle stiffness and spasms|Lockjaw| difficulty swallowing| muscle stiffness and spasms
Botulism|A rare but serious illness caused by a toxin that attacks the body's nerves|Weakness| blurred vision| feeling tired| trouble speaking| trouble swallowing| trouble breathing
Leptospirosis|A bacterial infection that affects humans and animals|High fever| headache| bleeding| muscle pain| chills| red eyes| and vomiting
Plague|An infectious disease caused by the bacterium Yersinia pestis|Fever| headache| chills| weakness| swollen and painful lymph nodes
Tularemia|A rare infectious disease that typically attacks the skin| eyes| lymph nodes| and lungs|Fever| skin ulcer| and enlarged lymph nodes
Brucellosis|A bacterial infection spread from animals to people| causing flu-like symptoms|Fever| sweats| malaise| anorexia| headache| pain in muscles| joint| and/or back| fatigue
Q Fever|An infection caused by the bacterium Coxiella burnetii|High fever| severe headache| muscle pain| confusion| nausea| vomiting| diarrhea| abdominal pain| chest pain
Legionnaires' Disease|A severe form of pneumonia caused by Legionella bacteria|Cough| shortness of breath| high fever| muscle pains| headaches
Cholera|A bacterial disease causing severe diarrhea and dehydration| usually spread in water|Severe diarrhea| dehydration| vomiting| rapid heart rate
Typhoid Fever|A bacterial infection that can spread throughout the body| affecting many organs|Prolonged fever| severe headache| nausea| loss of appetite| constipation or sometimes diarrhea| rash
Shigellosis|An infectious disease caused by a group of bacteria called Shigella|Diarrhea (sometimes bloody)| fever| and stomach cramps
Dysentery|An inflammatory disorder of the intestine causing severe diarrhea with blood|Diarrhea with blood| abdominal cramps| fever
Anthrax|A rare but serious illness caused by a spore-forming bacterium|Flu-like symptoms| such as sore throat| mild fever| fatigue and muscle aches| which may last a few hours or days| mild chest discomfort| shortness of breath| nausea| coughing up blood| painful swallowing| swelling of neck
Psittacosis|An infectious disease in humans caused by a bacterium called Chlamydia psittaci|Fever| chills| headache| muscle aches| dry cough
Tularemia|A highly infectious disease caused by the bacterium Francisella tularensis|Swollen lymph glands| fever| chills| sore throat| diarrhea| muscle aches| joint pain| dry cough| progressive weakness
Trichinosis|A parasitic disease caused by eating raw or undercooked pork or wild game infected with the larvae of a species of roundworm|Diarrhea| abdominal cramps| muscle pain| fever| swelling of the face| particularly the eyes
Filariasis|A parasitic disease caused by an infection with roundworms of the Filarioidea type|Severe swelling of limbs| genitalia| and other body parts| skin rashes| fever| and testicular pain and swelling
Leishmaniasis|A disease caused by protozoan parasites and spread by the bite of certain types of sandflies|Skin sores which erupt weeks to months after the person is bitten| fever| damage to the spleen and liver| anemia
Babesiosis|A malaria-like parasitic disease caused by infection with Babesia| commonly spread by ticks|Fever| chills| sweats| headache| body aches| loss of appetite| nausea| or fatigue
Cystic Fibrosis|An inherited disorder that causes severe damage to the lungs| digestive system and other organs in the body|Salty-tasting skin| persistent coughing| frequent lung infections| wheezing or shortness of breath| poor growth or weight gain in spite of a good appetite| frequent greasy| bulky stools or difficulty with bowel movements| male infertility
Hemophilia|A rare disorder in which your blood doesn't clot normally because it lacks sufficient blood-clotting proteins (clotting factors)|Unexplained and excessive bleeding from cuts or injuries| or after surgery or dental work| many large or deep bruises| unusual bleeding after vaccinations| pain| swelling or tightness in your joints| blood in your urine or stool| nosebleeds without a known cause
Sickle Cell Anemia|An inherited red blood cell disorder in which there aren't enough healthy red blood cells to carry oxygen throughout your body|Anemia| episodes of pain| swelling of hands and feet| frequent infections| delayed growth| vision problems
Thalassemia|A blood disorder involving less than normal amounts of an oxygen-carrying protein|Anemia| fatigue| weakness| pale or yellowish skin| facial bone deformities| slow growth| abdominal swelling| dark urine
Gaucher's Disease|An inherited disorder that affects many of the body's organs and tissues|Enlarged spleen and liver| severe neurologic complications| skeletal abnormalities| and bone pain
Huntington's Disease|An inherited disease that causes the progressive breakdown (degeneration) of nerve cells in the brain|Involuntary jerking or writhing movements (chorea)| muscle problems| such as rigidity or muscle contracture (dystonia)| slow or abnormal eye movements| impaired gait| posture and balance| difficulty with speech or swallowing
Fabry Disease|A rare genetic disorder that can affect many parts of your body| including your kidneys| heart| and skin|Episodes of pain| particularly in the hands and feet (acroparesthesia)| clusters of small| dark red spots on the skin (angiokeratomas)| a decreased ability to sweat (hypohidrosis)| cloudy vision (corneal opacity)| gastrointestinal problems| ringing in the ears (tinnitus)| and hearing loss
Maple Syrup Urine Disease|An inherited disorder in which the body is unable to process certain protein building blocks (amino acids) properly|Urine that smells like maple syrup| poor feeding| vomiting| lack of energy (lethargy)| abnormal movements| delayed development
Phenylketonuria (PKU)|A birth defect that causes an amino acid called phenylalanine to build up in the body|Intellectual disability| delayed development| behavioral| emotional and social problems| psychiatric disorders| neurological problems that may include seizures| hyperactivity| poor bone strength| skin rashes (eczema)| a musty odor in the breath| skin or urine| fair skin and blue eyes
Tay-Sachs Disease|A rare inherited disorder that progressively destroys nerve cells (neurons) in the brain and spinal cord|Loss of motor skills (such as turning over| sitting| and crawling)| exaggerated reactions when the baby hears loud noises| seizures| vision and hearing loss| "cherry-red" spots in the eyes| muscle weakness| movement problems
Alkaptonuria|A rare inherited genetic disorder that prevents the body from fully breaking down two protein building blocks (amino acids) called tyrosine and phenylalanine|Dark urine| ochronosis (bluish-black discoloration of tissue)| arthritis| particularly in the spine and large joints
Progeria|A progressive genetic disorder that causes children to age rapidly|Slowed growth| with below-average height and weight| narrow| shrunken or wrinkled face| baldness| loss of eyebrows and eyelashes| short stature| large head for size of face| open soft spot (fontanelle) on the head| small jaw (micrognathia)| dry| scaly| thin skin
Alzheimer's Disease|A progressive neurological disorder that causes brain cells to waste away and die|Memory loss| confusion| difficulty thinking and understanding| changes in personality
Parkinson's Disease|A progressive nervous system disorder that affects movement|Tremors| stiffness| slowness of movement| balance problems
Amyotrophic Lateral Sclerosis (ALS)|A progressive neurodegenerative disease that affects nerve cells in the brain and the spinal cord|Muscle weakness| twitching| cramping| stiffness| slurred speech| difficulty chewing and swallowing
Creutzfeldt-Jakob Disease|A degenerative brain disorder that leads to dementia and| ultimately| death|Rapidly developing delirium or dementia| confusion| memory problems| personality changes| muscle stiffness| twitches| and spasms| difficulty walking
